33333333333333333333333333333333333333333333333333333333333333333333333333333333333333333
33333333333333333333333333333333333333333333333333333333333333333333333333333333333333333
33333333333333333333333333333333333333333333333333333333333333333333333333333333333333333
33333333333333333333333333333333333333333333333333333333333333333333333333333333333333333
33333333333333333333333333333333333333333333333333333333333333333333333333333333333333333
33333333333333333333333333333333333333333333333333333333333333333333333333333333333333333
33333333333322222222222222222222222222222222222222222222222222222222222222222333333333333
33333333333322222222222222222222222222222222222222222222222222222222222222222333333333333
33333333333322222222222222222222222222222222222222222222222222222222222222222333333333333
33333333333322221111111111111111111111111111111111111111111111111111111112222333333333333
33333333333322211111111111111111111111111111111111111111111111111111111111222333333333333
33333333333322211111111111111111111111111111111111111111111111111111111111222333333333333
33333333333322211110000000001111100000000011111000000000111110000000001111222333333333333
33333333333322211100000000000111000000000001110000000000011100000000000111222333333333333
33333333333322211100000000000111000000000001110000000000011100000000000111222333333333333
33333333333322211100000000000111000000000001110000000000011100000000000111222333333333333
33333333333322211100000000000111000000000001110000000000011100000000000111222333333333333
33333333333322211100000000000111000000000001110000000000011100000000000111222333333333333
33333333333322211110000000001111100000000011111000000000111110000000001111222333333333333
33333333333322211111111111111111111111111111111111111111111111111111111111222333333333333
33333333333322211111111111111111111111111111111111111111111111111111111111222333333333333
33333333333322211111111111111111111111111111111111111111111111111111111111222333333333333
33333333333322211110000000001111100000000011111000000000111110000000001111222333333333333
33333333333322211100000000000111000000000001110000000000011100000000000111222333333333333
33333333333322211100000000000111000000000001110000000000011100000000000111222333333333333
33333333333322211100000000000111000000000001110000000000011100000000000111222333333333333
33333333333322211100000000000111000000000001110000000000011100000000000111222333333333333
33333333333322211100000000000111000000000001110000000000011100000000000111222333333333333
33333333333322211110000000001111100000000011111000000000111110000000001111222333333333333
33333333333322211111111111111111111111111111111111111111111111111111111111222333333333333
33333333333322211111111111111111111111111111111111111111111111111111111111222333333333333
33333333333322221111111111111111111111111111111111111111111111111111111112222333333333333
33333333333322222222222222222222222222222222222222222222222222222222222222222333333333333
33333333333322222222222222222222222222222222222222222222222222222222222222222333333333333
33333333333322222222222222222222222222222222222222222222222222222222222222222333333333333
33333333333333333333333333333333333333333333333333333333333333333333333333333333333333333
33333333333333333333333333333333333333333333333333333333333333333333333333333333333333333
33333333333333333333333333333333333333333333333333333333333333333333333333333333333333333
33333333333333333333333333333333333333333333333333333333333333333333333333333333333333333
33333333333333333333333333333333333333333333333333333333333333333333333333333333333333333
33333333333333333333333333333333333333333333333333333333333333333333333333333333333333333